#define rows 16;
#define cols 16;
#define maxPizzasPerRobot 1;
#define unvisited 0;
#define visited -1;
#define obstacle -2;
#define pizza -3;
#define house -4;
#define HOME_X 8;
#define HOME_Y 8;
var pizzasToDeliver = 4;

var world[rows][cols]:{-4..4} = [
 0,  0,  0,  0,  0,  0,  0,  0,  0,  0,  0,  0,  0,  0,  0,  0,
 0, -4, -1,  0,  0,  0,  0,  0,  0,  0,  0,  0,  0,  0,  0,  0,
-1, -1, -1, -1, -4,  0,  0,  0,  0,  0,  0,  0,  0,  0,  0,  0,
 3,  0,  4, -1, -1,  0,  0,  0,  0,  0,  0,  0,  0,  0,  0,  0,
-2,  0,  0,  0, -1,  0,  0, -2,  0,  0,  0,  0,  0,  0,  0,  0,
 0,  0,  0,  0, -1, -1,  1, -1, -1,  0,  0,  0,  0,  0,  0,  0,
 0,  0,  0,  0, -1, -1, -1, -1, -1, -1,  0,  0,  0,  0,  0,  0,
-4,  0,  0,  0,  0,  0, -1, -1,  0, -1,  0,  0,  0,  0,  0,  0,
 0,  0,  0,  0,  0,  0, -1, -1, -3, -1,  0,  0,  0,  0,  0,  0,
 0,  0,  0,  0,  0,  0, -1, -1,  2, -1,  0,  0,  0,  0,  0,  0,
 0,  0,  0,  0,  0,  0, -1, -1,  0, -1,  0,  0,  0,  0,  0,  0,
 0,  0,  0,  0,  0,  0, -1, -1,  0, -1,  0,  0,  0,  0,  0,  0,
 0,  0,  0,  0,  0,  0, -1, -1,  0, -1,  0,  0,  0,  0,  0,  0,
 0,  0,  0,  0,  0,  0, -1, -1, -1, -1,  0,  0,  0,  0,  0,  0,
 0,  0,  0,  0,  0,  0, -4, -1, -1,  0,  0,  0,  0,  0,  0,  0,
 0,  0,  0,  0,  0,  0,  0,  0,  0,  0,  0,  0,  0,  0,  0,  0
];